|-----------------------------------|
|---------....|----...-----n--------|
|-----------|.|--...|.......--------|
|---@.....|-|.|--.|-@--|.||..|------|
|-------|.|-|.|--.|-.--|.||-........|
|-------|............---...*------|X|
|-----------------------------------|